NO textures/sky_1.xpm
SO textures/sky_2.xpm
WE textures/sky_3.xpm
EA textures/sky_4.xpm



F 184, 34, 32

C 5,191,29

     1111111111111111
     1000000001100001
     1011000001111111
1111110000N10001
1011000001110001
1000000000110001  
1110111110011111
111101  1111 101    
111101111111 101
111111111111 111  




	




