NO textures/mossy.xpm
SO textures/bluestone.xpm
WE textures/redbrick.xpm
EA textures/eagle.xpm
DR textures/door.xpm
GN textures/pistol.xpm



F 139, 69, 19

C 135, 206, 235

     1111111111111111
     1000000001100001
     1011000001111111
1111110000N10001
1011000001110001
1000000000110001  
1000000000000001
111111D111101111    
1100000000001001
1111111111111111  




	




