NO textures/wood.xpm
SO textures/bluestone.xpm
WE textures/redbrick.xpm
EA textures/eagle.xpm



F 139, 69, 19

C 135, 206, 235

    1111111111111111
    1000000001111111
1111100001111111
1111110000N10001
1011000001110001
1000000000110001  
1110111110011111
1111010001111101    
1100000000000001
1111111111111111  




	




